w|w|w|w|w|w|w|w|w|
w|s|s|s|s|w|s|s|w|
w|s|s|s|s|s|s|s|e|
w|s|s|s|s|w|s|s|w|
w|s|s|s|s|s|s|s|w|
w|s|s|s|s|w|s|s|w|
