w|s|s|s|s|s|s|s|s|w|w|w|w|w|w|w|w|w|w|w|w|w|w|w|w|w|w|s|s|s|s|s|w|
w|s|s|s|s|s|s|s|s|w|s|s|s|s|s|s|w|s|s|s|s|s|s|s|s|s|w|s|s|s|s|s|w|
w|s|s|s|s|s|s|s|s|s|s|s|s|s|s|s|w|s|s|s|s|s|w|s|s|s|w|s|s|s|s|s|w|
w|s|s|s|s|s|s|s|s|w|w|w|w|s|w|w|w|s|s|s|s|s|w|s|s|s|w|w|s|w|w|w|w|
w|s|s|s|s|s|s|s|s|w|s|s|s|s|s|s|w|w|w|w|w|w|w|s|s|s|s|s|s|s|s|s|e|
w|s|s|s|s|s|s|s|s|w|s|s|s|s|s|s|s|s|s|s|s|s|s|s|s|s|w|s|s|s|s|s|w|
w|s|s|s|s|s|s|s|s|w|s|s|s|s|s|s|w|s|s|s|s|s|s|s|s|s|w|s|s|s|s|s|w|
w|s|s|s|s|s|s|s|s|w|s|s|s|s|s|s|w|s|s|s|s|s|s|s|s|s|w|s|s|s|s|s|w|
w|w|w|w|w|w|w|w|w|w|w|w|w|w|w|w|w|w|w|w|w|w|w|w|w|w|w|w|w|w|w|w|w|